50 14
19 19 19 19 19 19 19 19 19 19 19 19 19 19 19 19 19 19 19 19 19 19 2 3 19 19 19 19 19 19 19 19 19 19 19 19 19 19 19 19 19 19 19 19 19 19 19 19 19 19
19 19 19 19 19 19 19 19 19 19 19 2 3 19 19 19 19 19 19 19 19 19 19 19 19 19 19 19 19 19 19 19 19 19 19 19 19 2 3 19 19 19 19 19 19 19 19 19 19 19
19 19 19 19 19 19 19 19 19 19 19 19 19 19 19 19 19 19 19 19 19 19 19 19 19 19 19 19 19 19 19 19 19 19 19 19 19 19 19 19 19 19 19 19 19 2 3 19 19 19
19 19 19 19 19 19 19 19 19 19 19 19 19 19 19 19 19 19 2 3 19 19 19 19 19 19 19 19 19 2 3 19 19 19 19 19 19 19 19 19 19 19 19 19 19 19 19 19 19 19
19 19 19 19 19 19 19 19 19 19 19 19 19 19 19 19 19 19 19 19 19 19 19 19 19 19 19 19 19 19 19 19 19 19 19 19 19 19 19 19 19 2 3 19 19 19 19 19 19 19
19 19 19 19 19 2 3 19 19 19 19 19 19 19 26 27 19 19 19 19 19 19 19 19 19 19 19 19 19 19 19 19 19 19 19 19 19 19 19 19 19 19 19 19 19 19 19 19 19 19
19 19 19 19 19 19 19 19 19 19 2 3 19 28 29 30 19 19 19 19 19 19 19 19 19 2 3 19 19 19 19 19 19 19 2 3 19 19 19 19 19 19 19 19 19 19 19 19 19 19
2 3 19 19 19 19 19 19 19 19 19 19 28 29 29 29 30 19 19 2 3 19 19 19 19 5 6 7 19 19 19 19 19 19 19 19 40 40 19 19 19 19 19 40 19 19 19 19 19 19
19 19 19 19 19 19 19 19 19 19 19 28 29 29 29 29 29 30 19 19 19 19 19 19 19 41 13 19 19 19 19 19 19 19 19 19 37 37 36 19 19 19 19 37 36 19 19 19 19 19
19 19 19 19 19 19 19 19 19 19 28 29 29 29 29 29 29 29 30 19 19 19 19 19 19 4 4 4 19 44 44 19 19 19 19 19 37 37 37 36 19 19 19 37 37 36 19 19 43 43
19 19 19 19 19 19 19 19 19 28 29 29 29 29 29 29 29 29 29 30 19 19 19 19 4 4 4 4 4 4 4 4 47 48 19 35 37 37 37 37 36 19 35 37 37 37 36 31 8 8
4 4 4 4 4 4 4 4 4 4 4 4 4 4 4 4 4 4 4 4 4 17 17 17 4 4 4 4 4 4 4 4 4 4 4 33 38 38 38 38 34 20 33 38 38 38 34 20 20 20
18 18 18 18 18 18 18 18 18 18 18 18 18 18 18 18 18 18 18 18 18 18 18 18 18 18 18 18 18 19 19 19 19 19 19 19 19 19 19 19 19 19 19 19 19 19 19 19 19 19
18 18 18 18 18 18 18 18 18 18 18 18 18 18 18 18 18 18 18 18 18 18 18 18 18 18 18 18 19 19 19 19 19 19 19 19 19 19 19 19 19 19 19 19 19 19 19 19 19 19