50 30
1 1 2 2 2 2 2 2 2 2 2 2 2 2 2 2 2 2 2 2 2 2 2 2 2 2 2 2 2 2 2 2 2 2 2 2 2 2 2 2 2 2 2 2 2 2 2 2 2 2
1 1 1 1 1 1 1 1 1 1 1 1 1 1 1 2 2 2 2 3 9 9 9 9 9 9 9 9 9 9 9 3 2 2 2 2 1 1 1 1 1 1 1 12 1 1 1 1 1 2
12 1 1 2 1 1 1 1 1 1 12 1 1 1 1 2 2 2 2 3 9 6 6 6 6 6 6 6 6 6 9 3 2 2 2 2 1 1 1 12 1 1 1 1 1 1 1 1 1 2
1 1 2 1 12 2 12 1 1 1 1 1 1 1 1 2 2 2 2 3 9 6 7 7 7 7 7 7 7 6 9 3 2 2 2 2 1 1 1 1 1 12 1 1 1 1 1 12 1 2
12 1 1 1 2 1 1 2 1 1 1 1 12 1 1 2 2 2 2 3 9 9 7 8 8 8 8 8 7 9 9 3 2 2 2 2 1 1 12 1 1 1 1 1 1 1 1 1 1 2
1 1 1 1 1 1 2 1 1 2 1 1 1 1 12 2 2 2 2 3 9 9 7 8 8 15 8 8 7 9 9 3 2 2 2 2 1 1 1 1 1 12 1 1 1 1 12 1 1 1
1 1 1 1 12 1 1 1 2 1 1 2 1 1 1 2 2 2 2 3 4 6 7 8 8 8 8 8 7 6 4 3 2 2 2 2 1 1 12 1 1 1 1 1 1 1 1 1 1 1
1 1 1 1 1 1 1 1 1 1 2 1 1 2 1 2 2 2 2 3 4 6 7 7 7 7 7 7 7 6 4 3 2 2 2 2 1 1 1 1 1 1 12 1 1 1 12 1 1 1
1 1 12 1 1 1 1 1 12 1 1 1 2 1 1 2 2 2 2 3 4 6 6 6 6 6 6 6 6 6 4 3 2 2 2 2 1 1 1 1 1 1 1 1 1 1 1 1 1 1
1 1 1 1 1 1 1 1 1 1 1 1 1 1 1 2 2 2 2 3 4 4 4 4 4 4 4 4 4 4 4 3 2 2 2 2 1 1 1 1 1 1 1 1 1 1 1 1 1 1
1 1 1 1 1 1 1 1 1 1 1 1 1 1 1 1 1 1 1 1 1 1 1 1 1 1 1 1 1 1 1 1 1 1 1 1 1 1 12 1 1 1 1 1 12 1 1 1 1 1
1 1 1 1 1 1 1 1 1 1 1 1 1 1 1 1 1 1 12 1 1 1 1 1 1 12 1 1 1 12 1 1 1 1 1 1 1 1 1 1 12 1 1 1 1 1 1 1 1 1
1 1 12 1 1 1 1 1 1 12 1 1 1 1 1 1 1 1 1 1 1 1 1 1 1 1 1 1 1 1 1 1 1 1 12 1 1 1 1 1 1 1 1 1 1 1 1 1 1 1
1 1 1 1 1 1 1 1 1 1 1 1 1 1 1 1 1 1 1 1 12 1 1 1 1 12 1 1 1 1 1 12 1 1 1 1 1 1 1 1 12 1 1 1 1 1 1 1 1 1
1 1 1 1 1 1 1 1 1 1 1 1 1 1 1 1 1 1 12 1 1 1 1 1 1 1 1 1 1 1 1 1 1 1 1 1 1 1 1 1 1 1 1 1 1 1 1 1 1 1
1 1 1 0 0 0 0 1 1 1 1 1 1 1 1 1 1 1 1 1 1 1 16 1 1 1 1 1 1 1 1 1 1 1 1 1 1 1 1 1 1 1 1 1 1 1 1 1 1 1
16 1 0 0 0 0 0 0 1 1 1 1 1 1 1 1 1 1 1 0 0 0 0 0 1 1 1 1 1 1 1 1 1 1 1 1 1 1 1 1 1 1 1 1 1 1 1 1 1 1
0 0 0 0 0 0 0 0 0 0 0 1 1 1 1 1 1 1 1 0 0 0 0 0 0 1 1 1 1 1 1 1 1 1 1 1 1 1 1 1 1 1 1 1 1 1 1 1 1 1
18 0 0 0 0 0 0 0 0 0 18 17 17 17 17 17 17 17 0 0 0 0 0 0 0 1 1 1 1 1 1 1 1 1 1 1 1 1 1 1 1 1 1 1 1 1 1 1 1 1
18 0 0 0 0 0 0 0 0 0 18 18 18 18 18 18 18 0 0 0 0 0 0 0 0 0 17 17 17 17 17 17 17 17 17 17 17 17 17 17 17 17 17 17 17 17 0 1 1 1
18 18 0 0 0 0 0 0 0 0 18 18 18 18 18 18 18 0 0 0 22 22 22 22 22 22 18 18 18 18 18 18 18 18 18 18 18 18 18 18 18 18 18 18 18 18 0 0 0 0
18 18 18 0 0 0 0 0 0 18 18 18 18 18 18 18 0 0 0 20 10 10 10 10 10 10 18 18 18 18 18 18 18 18 18 18 18 18 18 18 18 18 18 18 18 0 0 0 0 0
19 19 19 20 20 20 20 20 20 19 19 19 19 19 19 0 0 0 21 10 10 10 10 10 10 10 18 18 18 18 18 18 18 18 10 10 10 18 18 18 18 18 18 18 0 0 0 0 0 0
10 10 10 10 10 10 10 10 10 10 10 10 10 10 10 10 10 10 10 10 10 10 10 10 10 10 10 10 10 10 10 18 18 10 10 10 10 10 10 10 10 10 10 10 0 0 0 0 0 0
10 10 10 10 10 10 10 10 10 10 10 10 10 10 10 10 10 10 10 10 10 10 10 10 10 10 10 10 10 10 10 10 10 10 10 10 10 10 10 10 10 10 0 0 0 0 0 0 0 0
10 10 10 10 10 10 10 10 10 10 10 10 10 10 10 10 10 10 10 10 10 10 10 10 10 10 10 10 10 10 10 10 10 10 10 10 10 10 10 10 19 0 0 0 0 0 0 0 0 0
10 10 10 10 10 10 10 10 10 10 10 10 10 10 10 10 10 10 10 10 10 10 10 10 10 10 10 10 10 10 10 10 10 10 10 10 10 10 10 19 0 0 21 21 20 22 22 20 22 20
19 19 19 19 19 19 19 19 19 19 19 19 19 19 19 19 19 19 19 19 19 19 19 19 19 19 19 19 19 19 19 19 19 19 19 19 19 19 19 19 19 19 19 19 19 19 19 19 19 19
19 0 19 19 0 0 19 19 19 0 19 19 0 19 19 0 19 19 19 19 0 19 19 19 19 19 19 19 19 19 19 19 19 19 19 19 19 19 19 19 19 19 19 19 19 19 19 19 19 19
0 0 0 0 0 0 0 0 0 0 0 0 0 0 0 0 0 0 0 0 0 0 0 0 0 0 0 0 0 0 0 0 0 0 0 0 0 0 0 0 0 0 0 0 0 0 0 0 0 0