50 14
19 19 19 19 19 19 19 19 19 19 19 19 19 19 19 19 19 19 19 19 19 19 2 3 19 19 19 19 19 19 19 19 19 19 19 19 19 19 19 19 19 19 19 19 19 19 19 19 19 19
19 19 19 19 19 19 19 19 19 19 19 2 3 19 19 19 19 19 19 19 19 19 19 19 19 19 19 19 19 19 19 19 19 19 19 19 19 2 3 19 19 19 19 19 19 19 19 19 19 19
19 19 19 19 19 19 19 19 19 19 19 19 19 19 19 19 19 19 19 19 19 19 19 19 19 19 19 19 19 19 19 19 19 19 19 19 19 19 19 19 19 19 19 19 19 2 3 19 19 19
19 19 19 19 19 19 19 19 19 19 19 19 19 19 19 19 19 19 2 3 19 19 19 19 19 19 19 19 19 2 3 19 19 19 19 19 19 19 19 19 19 19 19 19 19 19 19 19 19 19
19 19 19 19 19 19 19 19 19 19 19 19 19 19 19 19 19 19 19 19 19 19 19 19 19 19 19 19 19 19 19 19 19 19 19 19 19 19 19 19 19 2 3 19 19 19 19 19 19 19
19 19 19 19 19 2 3 19 19 19 19 19 19 19 26 26 19 19 19 19 19 19 19 19 19 19 19 19 19 19 19 19 19 19 19 19 19 19 19 19 19 19 19 19 19 19 19 19 19 19
19 19 19 19 19 19 19 19 19 19 2 3 19 46 47 47 25 19 19 19 19 19 19 19 19 2 3 19 19 19 19 19 19 19 2 3 19 37 37 37 38 19 19 19 37 38 19 19 19 19
2 3 19 19 19 19 19 19 19 19 19 19 46 47 47 47 47 25 19 2 3 19 19 19 19 5 6 7 19 19 19 19 19 19 19 19 32 34 34 34 33 19 19 32 34 33 19 19 19 19
19 19 19 19 19 19 19 19 19 19 19 46 47 47 47 47 47 47 25 19 19 19 19 19 19 41 13 19 19 19 19 19 19 19 19 32 34 34 34 34 34 33 32 34 34 34 33 19 19 19
19 19 19 5 6 7 19 19 19 19 46 47 47 47 47 47 47 47 47 25 19 19 19 19 19 4 4 4 19 44 45 19 19 19 28 32 34 34 34 34 34 34 34 34 34 34 34 33 43 43
19 19 19 19 13 19 19 19 19 46 47 47 47 47 47 47 47 47 47 47 25 19 19 19 4 4 4 4 4 4 4 4 19 19 28 30 35 35 35 35 35 35 35 35 35 35 35 31 8 8
4 4 4 4 4 4 4 4 4 4 4 4 4 4 4 4 4 4 4 4 4 17 17 17 4 4 4 4 4 4 4 4 4 4 4 20 20 20 20 20 20 20 20 20 20 20 20 20 20 20
18 18 18 18 18 18 18 18 18 18 18 18 18 18 18 18 18 18 18 18 18 18 18 18 18 18 18 18 18 19 19 19 19 19 19 19 19 19 19 19 19 19 19 19 19 19 19 19 19 19
18 18 18 18 18 18 18 18 18 18 18 18 18 18 18 18 18 18 18 18 18 18 18 18 18 18 18 18 19 19 19 19 19 19 19 19 19 19 19 19 19 19 19 19 19 19 19 19 19 19