40 20
9 9 9 9 9 9 9 9 9 9 9 9 9 9 9 9 9 9 1 1 1 1 1 1 1 1 1 1 1 1 1 1 1 1 1 1 1 1 1 1
9 9 9 9 9 9 9 9 9 9 9 9 9 9 9 9 9 9 1 1 1 1 1 1 1 1 12 1 1 1 1 1 1 12 1 1 1 1 1 1
9 9 9 9 9 9 9 9 9 9 9 9 9 9 9 9 9 9 1 1 1 1 1 1 1 1 1 1 1 1 1 1 1 1 1 1 1 1 12 1
9 9 9 9 9 9 9 9 9 9 9 9 9 9 9 9 9 9 9 1 1 1 1 1 1 1 1 1 1 1 1 1 1 1 1 1 1 1 1 1
9 9 9 9 9 9 9 9 9 9 9 9 9 9 9 9 9 9 12 1 1 1 1 1 1 1 1 1 1 1 12 1 1 1 12 1 1 1 1 1
9 9 9 9 9 9 9 9 9 9 9 9 9 9 9 9 9 9 9 9 1 1 1 1 1 1 1 1 1 1 1 1 1 1 1 1 1 1 1 1
9 9 9 9 9 9 9 9 9 9 9 9 9 9 9 9 9 9 9 1 1 1 1 1 12 1 1 1 1 1 1 1 1 1 1 12 1 1 1 1
9 9 9 9 9 9 9 9 9 9 9 9 9 9 9 9 9 9 1 1 1 1 9 9 1 9 1 1 1 1 1 1 1 1 1 1 1 1 1 12
9 9 9 9 9 9 9 9 9 9 9 9 9 9 9 9 9 9 1 1 9 9 9 1 1 9 1 1 1 1 1 1 1 12 1 1 1 1 1 1
9 9 9 9 9 9 9 9 9 9 9 9 9 9 9 9 9 9 9 9 9 9 9 1 9 9 9 1 9 1 1 9 1 9 9 1 9 9 9 9
9 9 9 9 9 9 9 9 9 9 9 9 9 9 9 9 9 9 9 9 9 9 9 9 9 9 9 9 9 9 9 9 9 9 9 9 9 9 9 9
9 9 9 9 9 9 9 9 9 9 9 9 9 9 9 9 9 9 9 9 9 9 9 9 9 9 9 9 9 9 9 9 9 9 9 9 9 9 9 9
9 9 9 9 9 9 9 9 9 26 27 9 9 9 9 9 9 9 9 9 9 9 9 9 9 9 9 9 9 9 9 9 9 9 9 9 9 9 9 9
9 9 9 9 9 9 9 9 49 29 30 9 9 9 9 9 9 9 40 41 9 9 9 9 9 9 9 9 9 9 9 9 9 9 9 9 9 9 9 9
9 9 6 7 9 9 9 49 29 29 29 30 9 9 9 9 9 9 37 36 41 9 9 9 9 9 9 9 9 9 9 9 9 9 9 9 9 9 9 9
9 9 13 9 9 9 49 29 29 29 29 29 30 9 9 9 9 9 37 37 36 41 9 9 9 9 9 9 9 9 9 9 9 9 9 9 9 9 9 9
16 9 13 9 9 49 29 29 29 29 29 29 29 30 9 9 9 9 37 37 37 36 41 9 9 9 9 9 9 9 9 9 9 9 9 17 17 17 17 17
17 17 17 17 17 17 17 17 17 17 17 17 17 17 17 17 17 35 37 37 37 37 36 9 9 9 9 9 9 9 9 9 9 9 9 18 18 18 18 18
18 18 18 18 18 18 18 18 18 18 18 18 18 18 18 18 18 33 38 38 38 38 34 17 17 17 17 17 17 17 17 17 17 17 17 18 18 18 18 18
18 18 18 18 18 18 18 18 18 18 18 18 18 18 18 18 18 18 18 18 18 18 18 18 18 18 18 18 18 18 18 18 18 18 18 18 18 18 18 18