50 20
9 9 9 9 9 9 9 9 9 9 9 9 9 9 9 9 9 9 9 9 9 9 9 9 9 9 9 9 9 9 9 9 9 9 9 9 9 9 9 9 9 9 9 9 9 9 9 9 9 9
9 9 9 9 9 9 9 9 9 9 9 9 9 9 9 9 9 9 9 10 9 9 9 9 9 9 9 9 9 9 9 9 9 9 9 9 9 10 9 9 9 9 9 10 9 9 9 9 9 9
9 9 9 9 9 9 9 9 9 9 9 9 9 9 9 9 9 9 9 9 9 9 9 9 9 9 9 9 9 9 9 9 9 9 9 9 9 9 9 10 10 9 9 9 9 9 9 9 9 9
9 9 9 9 9 9 9 9 9 9 9 9 9 9 9 9 11 10 9 9 9 9 9 9 9 9 9 9 9 9 9 10 9 9 9 9 9 9 9 9 9 9 9 9 9 9 9 9 9 9
9 9 9 9 9 9 9 9 9 9 9 9 9 9 9 9 9 9 10 9 9 9 9 9 9 9 9 9 9 9 9 9 9 9 9 10 9 9 9 10 9 9 9 9 9 9 9 9 9 9
9 9 9 9 9 9 9 9 9 9 9 9 9 9 9 9 9 9 9 9 9 9 9 9 9 10 9 9 9 9 9 9 9 9 9 9 9 9 9 9 9 9 9 9 9 9 9 9 9 9
9 9 9 9 9 9 9 9 9 10 9 9 9 9 9 9 9 9 9 9 9 9 10 10 9 9 9 9 9 9 9 9 9 10 9 9 9 9 9 9 9 9 9 10 10 9 9 9 9 9
9 9 9 9 9 9 9 9 9 9 9 9 9 9 9 10 9 9 9 9 9 9 9 9 9 10 9 9 9 9 9 9 9 9 9 9 9 9 9 9 9 9 9 9 9 9 9 9 9 9
10 10 9 9 9 9 9 9 10 9 9 10 9 9 9 9 9 9 9 9 9 9 9 9 9 9 9 9 9 9 9 9 9 10 9 9 9 9 9 9 9 9 9 9 10 9 9 9 9 9
9 9 9 9 9 9 9 9 9 9 9 9 9 10 9 9 9 9 9 9 9 9 9 9 9 9 9 9 9 9 9 9 9 9 9 10 10 9 9 9 9 9 9 9 9 9 9 10 9 9
9 9 9 9 9 9 9 9 9 9 9 9 9 10 9 9 9 9 9 9 9 9 9 9 9 9 9 37 9 9 9 9 9 9 9 9 9 9 9 9 9 9 9 10 9 9 9 9 9 9
9 9 9 9 10 9 9 9 9 9 9 9 9 9 9 9 9 9 37 38 9 9 9 9 9 9 9 34 9 9 9 9 9 9 9 9 9 9 9 9 9 9 9 9 9 9 9 9 9 10
9 9 9 9 9 26 10 9 9 9 9 9 9 9 9 9 9 32 34 33 38 9 9 9 9 9 34 34 33 9 9 9 9 9 6 7 10 9 6 7 9 9 9 9 26 9 9 9 9 9
9 9 9 9 46 47 25 9 9 9 9 9 9 9 9 9 9 32 34 34 33 38 9 9 9 34 34 34 34 33 9 9 9 9 13 9 9 9 13 9 9 9 9 46 47 25 9 9 9 9
9 9 10 46 47 47 47 25 9 9 9 9 9 9 9 9 32 32 34 34 34 33 9 9 32 34 34 34 34 34 34 33 9 9 13 9 9 9 13 9 9 9 46 47 47 47 25 9 9 9
9 9 46 47 47 47 47 47 25 9 9 9 9 9 9 28 30 35 35 35 35 31 36 28 30 35 35 35 35 35 35 31 9 46 47 47 47 47 47 25 9 46 47 47 47 47 47 25 9 9
16 46 47 47 47 47 47 47 47 25 9 9 9 9 9 28 18 18 18 18 18 18 47 47 18 18 18 18 18 18 18 18 17 17 17 17 17 17 17 17 17 17 17 17 17 17 17 17 17 17
18 18 18 18 18 18 18 18 18 18 17 17 17 17 17 17 18 18 18 18 18 18 18 18 18 18 18 18 18 18 18 18 18 18 18 18 18 18 18 18 18 18 18 18 18 18 18 18 18 18
18 18 18 18 18 18 18 18 18 18 18 18 18 18 18 18 18 18 18 18 18 18 18 18 18 18 18 18 18 18 18 18 18 18 18 18 18 18 18 18 18 18 18 18 18 18 18 18 18 18
18 18 18 18 18 18 18 18 18 18 18 18 18 18 18 18 18 18 18 18 18 18 18 18 18 18 18 18 18 18 18 18 18 18 18 18 18 18 18 18 18 18 18 18 18 18 18 18 18 18