34 14
19 19 19 19 19 19 19 19 19 19 19 19 19 19 19 19 19 19 24 25 19 19 19 19 19 19 19 19 19 19 19 19 19 19
19 24 25 19 19 19 19 19 24 25 19 19 19 19 19 19 19 19 19 19 19 19 19 19 19 19 19 19 19 19 19 19 24 25
19 19 19 12 13 19 19 19 19 19 19 19 19 24 25 19 19 19 19 19 19 19 19 19 24 25 19 19 19 19 19 19 19 19
19 19 19 18 19 19 19 19 19 19 19 19 19 19 19 19 19 19 19 19 19 19 19 19 19 19 19 19 19 19 19 19 19 19
19 19 19 19 19 24 25 19 19 19 19 19 19 19 19 19 19 19 24 25 19 19 19 24 25 19 19 19 19 19 19 19 19 19
19 24 25 19 19 19 19 19 19 19 19 19 19 19 19 19 19 19 19 19 19 19 19 19 19 3 4 24 25 19 19 19 24 25
19 19 19 19 19 19 13 19 19 19 19 24 25 19 19 19 19 19 19 19 24 25 19 19 3 0 0 4 19 19 19 19 19 19
19 19 19 19 19 19 13 19 19 19 19 19 21 21 21 21 19 19 19 19 19 19 19 3 0 0 0 0 4 19 19 19 10 11
19 19 19 19 19 13 13 13 13 13 13 19 27 27 27 27 19 19 19 19 19 19 3 0 0 0 0 0 0 4 19 19 16 17
19 19 3 4 19 10 11 13 13 19 19 27 27 27 27 27 28 19 19 19 19 3 0 0 0 0 0 0 0 0 4 8 20 20
19 3 0 0 4 16 17 13 13 1 26 27 27 27 27 27 27 29 19 19 3 0 0 0 0 0 0 0 0 0 0 4 20 20
0 0 0 0 0 0 0 0 0 0 7 7 7 7 7 7 7 7 0 0 0 0 0 0 0 0 0 0 0 0 0 0 7 7
0 0 0 0 0 0 0 0 0 0 0 0 7 7 7 7 7 7 7 7 7 7 7 7 7 7 7 7 7 7 7 7 7 7
0 0 0 0 0 0 0 0 0 0 0 0 5 20 20 20 20 20 20 20 20 20 20 20 20 20 20 20 20 20 20 20 20 20