34 14
1 1 1 1 1 1 1 1 1 1 1 1 1 1 1 1 1 1 1 1 1 1 1 1 1 1 1 1 1 1 1 1 1 1
1 1 3 1 1 1 1 1 1 32 32 32 1 1 1 1 1 1 1 1 1 1 1 1 1 1 1 1 1 1 1 1 1 1
1 1 1 1 1 1 1 1 1 1 1 1 1 1 1 1 1 1 1 32 32 32 1 1 1 1 1 1 1 1 1 1 1 1
1 32 32 32 1 1 1 1 1 1 1 1 1 1 1 1 1 1 1 1 1 1 1 1 1 1 1 1 1 1 1 1 1 1
1 1 1 1 1 1 1 1 1 1 1 1 1 1 1 1 1 1 1 1 1 1 1 1 1 1 1 1 1 1 1 1 1 1
1 1 1 1 1 1 1 1 1 1 1 1 1 1 1 1 1 1 1 1 1 1 1 1 1 1 1 1 1 1 1 1 1 1
1 1 1 1 1 1 1 1 1 1 1 1 1 1 1 1 1 1 1 1 1 1 1 1 1 1 1 1 1 1 1 1 1 1
1 1 1 1 1 1 30 1 1 1 1 1 1 1 1 1 1 1 1 1 1 1 1 1 1 1 1 1 1 1 1 1 1 10
1 1 1 1 1 1 29 1 31 1 1 1 1 1 1 1 1 1 1 1 1 1 1 1 1 1 1 1 1 1 1 1 2 2
1 1 1 1 23 25 26 25 24 1 1 1 1 1 1 1 1 1 1 1 1 1 27 27 1 1 1 1 1 1 1 2 2 2
1 1 1 1 21 27 27 27 22 1 11 11 1 1 1 1 1 1 27 27 1 1 1 1 1 27 27 1 1 1 2 2 2 2
1 1 2 14 14 14 14 14 14 14 14 14 14 0 0 0 0 14 14 14 14 14 14 14 14 14 14 14 14 2 2 2 2 2
1 2 2 15 15 15 15 15 15 15 15 15 15 2 2 2 2 15 15 15 15 15 15 15 15 15 15 15 2 2 2 2 2 2
2 2 2 15 15 15 15 15 15 15 15 15 15 2 2 2 2 2 2 2 2 2 2 2 2 2 2 2 2 2 2 2 2 2