34 14
19 19 19 19 19 19 19 19 19 19 19 19 19 19 19 19 19 19 19 19 19 19 19 19 19 19 19 19 19 19 19 19 19 19
19 24 25 19 19 19 19 19 24 25 19 19 24 25 19 19 19 19 19 19 19 19 19 19 24 25 19 19 19 19 24 25 19 19
19 12 13 19 19 19 19 19 19 19 19 19 19 19 19 19 19 24 25 19 19 19 19 19 19 19 19 19 19 19 19 19 19 19
19 18 19 19 19 19 19 19 19 19 19 19 19 19 19 19 19 19 19 19 19 19 19 19 19 19 19 19 19 19 19 19 19 19
19 19 19 19 19 19 19 19 19 19 19 19 19 19 19 19 19 19 19 19 19 19 24 25 19 19 19 19 19 19 19 24 25 19
19 19 19 19 19 24 25 19 19 19 19 19 19 19 19 19 19 19 19 19 19 19 19 19 19 19 19 10 11 19 19 19 19 19
19 19 19 19 19 19 13 19 19 19 19 19 19 19 24 25 19 19 19 19 19 19 19 19 19 24 25 16 17 19 19 19 19 19
19 24 25 19 19 19 13 25 19 19 19 19 19 19 19 19 19 19 19 19 19 19 19 19 19 19 3 0 0 4 19 19 10 11
19 19 19 19 19 19 21 21 21 22 23 19 19 19 19 19 19 19 19 19 19 19 19 19 19 3 0 0 0 0 4 19 16 17
19 19 19 19 19 21 27 27 27 27 29 21 19 10 11 19 19 19 19 22 19 19 19 19 3 0 0 0 0 0 0 4 20 20
19 19 3 4 26 27 27 27 27 27 27 27 29 16 17 19 19 19 26 27 28 28 29 3 0 0 0 0 0 0 0 0 20 20
19 3 0 0 0 7 7 7 7 7 7 7 7 0 0 0 0 0 7 7 7 7 7 7 7 7 7 7 7 7 7 7 20 20
3 0 0 0 0 7 7 7 7 7 7 7 7 7 7 7 7 7 7 7 7 7 7 7 7 7 7 7 7 7 20 20 20 20
7 7 7 7 7 7 7 7 7 7 7 7 7 7 7 7 7 7 7 7 7 7 7 7 7 7 7 7 20 20 20 20 20 20