34 14
9 9 9 9 9 9 9 9 9 9 9 9 9 9 9 9 9 9 9 9 9 9 9 9 9 9 9 9 9 9 9 9 9 9
9 9 9 9 9 9 9 9 9 9 9 9 9 9 9 9 9 9 9 9 9 9 9 9 9 9 9 9 9 9 9 9 9 25
9 9 9 9 9 9 9 9 9 9 9 9 9 9 9 9 9 9 9 9 9 9 9 9 9 9 9 9 9 9 9 9 9 9
9 9 9 9 9 9 9 9 9 9 9 9 9 9 9 9 9 9 9 9 9 9 9 9 9 9 9 9 9 9 9 9 9 9
9 9 9 9 9 9 9 9 9 9 9 9 9 9 9 9 9 9 9 9 9 9 9 9 9 9 9 9 9 9 9 9 9 9
9 9 9 9 9 9 9 9 9 9 9 9 9 9 9 9 9 9 9 9 9 9 9 9 9 9 9 9 9 9 9 9 9 9
9 9 9 9 9 9 9 9 9 9 9 9 9 9 9 9 9 9 9 9 9 9 9 9 9 9 9 9 9 9 9 9 9 9
9 9 9 9 9 9 9 9 9 9 9 9 9 26 27 9 9 9 9 9 9 9 9 9 9 6 7 9 9 9 9 9 9 9
9 9 9 40 40 9 9 9 9 9 9 9 28 29 30 9 9 9 9 9 9 9 9 6 7 13 9 9 9 9 9 9 9 9
9 9 9 37 37 36 9 9 9 9 9 28 29 29 29 30 9 9 9 9 9 9 9 13 9 13 6 7 9 9 9 9 9 9
9 9 9 37 37 37 36 9 9 9 28 29 29 29 29 29 30 9 9 9 9 9 9 13 9 13 13 9 9 9 9 9 9 9
16 9 35 37 37 37 37 36 9 28 29 29 29 29 29 29 29 30 9 9 47 48 9 13 9 13 13 9 9 9 9 9 9 9
18 17 33 38 38 38 38 34 17 17 17 17 17 17 17 17 17 17 17 17 17 17 17 17 17 17 17 17 17 17 17 17 17 17
18 18 18 18 18 18 18 18 18 18 18 18 18 18 18 18 18 18 18 18 18 18 18 18 18 18 18 18 18 18 18 18 18 18