34 14
19 19 19 19 19 19 19 19 19 19 19 19 19 19 19 19 19 19 19 19 19 19 19 19 19 19 19 19 19 19 19 19 19 19
19 19 19 19 19 19 19 19 19 19 19 19 19 19 19 19 19 19 19 19 19 19 19 19 19 19 19 19 19 19 19 19 19 19
19 19 19 19 19 19 19 19 19 19 19 19 19 19 19 19 19 19 19 19 19 19 19 19 19 19 19 19 19 19 19 19 19 19
19 19 19 19 19 19 19 19 19 19 19 19 19 19 19 19 19 19 19 19 19 19 19 19 19 19 19 19 19 19 19 19 19 19
19 19 19 19 19 19 19 19 19 19 19 19 19 19 19 19 19 19 19 19 19 19 19 19 19 19 19 19 19 19 19 19 19 19
19 19 19 19 19 19 19 19 19 19 19 19 19 19 19 19 19 19 19 19 19 19 19 19 19 19 19 19 19 19 19 19 19 19
19 19 19 19 19 19 13 19 19 19 19 19 19 19 19 19 19 19 19 19 19 19 19 19 19 19 19 19 19 19 19 19 19 19
19 19 19 19 19 19 13 19 19 19 19 19 19 19 19 19 19 19 19 19 19 19 19 19 19 19 19 19 19 19 19 19 19 19
19 19 19 19 19 13 13 13 13 13 13 19 19 19 19 19 19 19 19 19 19 19 19 19 19 19 19 19 19 19 19 19 16 16
19 19 24 25 24 25 13 13 13 19 19 19 19 19 19 19 19 19 19 19 19 19 27 27 19 19 19 19 19 19 19 11 20 20
19 19 19 19 3 4 13 13 13 19 19 19 19 19 19 19 19 19 27 27 19 19 19 19 14 14 14 14 14 14 20 20 20 20
0 0 0 0 0 0 0 0 0 0 0 0 7 7 7 7 7 7 14 14 14 14 14 14 15 15 15 15 15 20 20 20 20 20
0 0 0 0 0 0 0 0 0 0 0 0 7 7 7 7 7 15 15 15 15 15 15 15 15 15 15 15 15 20 20 20 20 20
0 0 0 0 0 0 0 0 0 0 0 0 5 20 20 20 20 20 20 20 20 20 20 20 20 20 20 20 20 20 20 20 20 20