20 15
14 14 14 13 13 13 13 13 13 14 14 14 14 14 14 14 14 14 14 14
14 14 13 13 13 13 13 13 13 13 14 14 14 14 14 14 14 14 14 14
14 14 13 14 13 13 13 13 14 13 14 14 14 14 14 14 14 14 14 14
14 14 13 14 14 13 13 14 14 13 14 14 14 14 14 14 14 14 14 14
14 14 14 13 13 14 14 13 13 14 14 14 14 14 14 14 14 14 14 14
14 14 14 14 13 13 13 13 14 14 14 14 14 14 14 14 14 14 14 14
14 14 14 13 14 14 14 14 13 14 14 14 14 14 14 14 14 14 14 14
14 14 14 14 13 13 13 13 14 14 14 14 14 14 14 14 14 14 14 14
14 14 14 14 14 14 14 14 14 14 14 14 14 14 14 14 14 14 14 14
14 14 14 14 14 14 14 14 14 14 14 14 14 14 14 14 14 14 14 14
14 14 14 14 14 14 14 14 14 14 14 14 14 14 14 14 14 14 14 14
14 14 14 14 14 14 14 14 14 14 14 14 14 14 14 14 14 14 14 14
14 14 14 14 14 14 14 14 14 14 14 14 14 14 14 14 14 14 14 14
14 14 14 14 14 14 14 14 14 14 14 14 14 14 14 14 14 14 14 14
14 14 14 14 14 14 14 14 14 14 14 14 14 14 14 14 14 14 14 14