17 13
19 19 19 19 19 19 19 19 19 19 19 19 19 19 19 19 19
19 3 19 19 19 19 19 19 19 19 19 19 19 19 19 19 19
19 19 19 19 19 19 19 19 19 19 19 19 19 19 19 19 19
19 19 19 19 19 19 19 19 19 19 19 19 19 19 19 19 19
19 19 19 19 19 19 19 19 19 19 19 19 19 19 19 19 19
19 19 19 19 19 19 19 30 19 19 19 19 19 19 19 19 19
19 19 19 19 19 19 19 29 19 19 19 19 19 19 19 19 19
19 19 19 19 19 19 19 29 19 31 19 19 19 19 19 19 19
19 19 19 19 19 23 25 26 25 24 19 19 19 19 19 19 19
19 19 19 19 19 21 27 28 28 22 19 19 19 19 19 19 19
20 14 14 14 14 14 14 14 14 14 14 14 14 14 14 14 20
20 15 15 15 15 15 15 15 15 15 15 15 15 15 15 15 20
20 20 20 20 20 20 20 20 20 20 20 20 20 20 20 20 20