17 13
1 1 1 1 1 1 1 1 1 1 1 1 1 1 1 1 1
1 3 1 1 1 1 1 1 1 1 1 1 1 1 1 1 1
1 1 1 1 1 1 1 1 1 1 1 1 1 1 1 1 1
1 1 1 1 1 1 1 1 1 1 1 1 1 1 1 1 1
1 1 1 1 1 1 1 1 1 1 1 1 1 1 1 1 1
1 1 1 1 1 1 1 30 1 1 1 1 1 1 1 1 1
1 1 1 1 1 1 1 29 1 1 1 1 1 1 1 1 1
1 1 1 1 1 1 1 29 1 31 1 1 1 1 1 1 1
1 1 1 1 1 23 25 26 25 24 1 1 1 1 1 1 1
1 1 1 1 1 21 27 28 28 22 1 1 1 1 1 1 1
2 14 14 14 14 14 14 14 14 14 14 14 14 14 14 14 2
2 15 15 15 15 15 15 15 15 15 15 15 15 15 15 15 2
2 2 2 2 2 2 2 2 2 2 2 2 2 2 2 2 2